    --------------------                
    |..................|-----------     
    |...&..........................|    
    |..............................|    
    |..................|-----------     
    |..................|                
    |..................|-----------     
    |..............................|    
    |..............................|    
    |..............................|    
    |..............................|    
    |..............................|    
    |..................|-----------     
    |..................|                
    |..................|-----------     
    |..............................|    
    |..............................|    
    |..................|-----------     
    --------------------                