    ----------------                   
    |..............|                   
    |.........&....|                   
    |.......o......|---------------    
    |.............................|    
    |.............................:    
    |.............................|    
    -------------------------------    