    ----------------                   
    |..............|                   
    :.........&....|                   
    |.......o......|---------------    
    |.............................|    
    |..^......E..E................:    
    |.............................|    
    -------------------------------    