    ----------------                   
    |..............|                   
    :.........&....|                   
    |.......o......|---------------    
    |.............................|    
    |.........E...................:    
    |.............................|    
    -------------------------------    