    --------------------                
    |..................|-----------     
    :..............................|    
    |......&.......................|    
    |..................|-----------     
    |..................|                
    |..................|-----------     
    |.....B........................|    
    |..............................|    
    |..............................|    
    |..............................|    
    |..............................|    
    |..................|                
    |..................|                
    |..................|-----------     
    |..............................|    
    |..............................|    
    |..................|-----------     
    --------------------                