    ------------    
    |..........|    
    |..&.......:    
    |..........|    
    |..o..o....|    
    |..........|    
    |.....o....|    
    |..........|    
    ------------    