    ----------------                   
    |..............|                   
    |.........&....|                   
    |.......o......|---------------    
    |.............................|    
    |.........E...................:    
    |.............................|    
    -------------------------------    